111111111
1P10ECCC1
111000001
111111111
