1111111111111111111111
1000000000000C0000C001
1000G000000000000G0001
10000100000P0010000001
1C0C010000000010000001
10CEC11100000010000001
100C00000000000C000001
1111111111111111111111
