1111111
1PCEC11
1000C11
1111111
