1111111111111111111111111111111111111111
1P00G000G11C0GC0GGGGG1GGG00C0000C000CGC1
1CG0GCG00GGG0GG0G00CGG1GG0G0G00GGGG00G01
1CGCG0GGCGG0000000GGGGG1GCGCG0CGCGG00001
1CG0G0GGCGG0GGGGGGGGG11GG0GGG00G0GGGGGG1
1CGC00GG00000000000000000000000000000001
1GGGGGGGGGGGG0GGGGGGGG0GGGGGGGGGGG0GGGG1
1GC00GGC0CCCG0GGGCGGGGCGGGGGGG000G000CG1
1G0GCGCGGGCGG0GGC000CCCGGGGC0000G0CGCGG1
1G0G0G0GGC0CG0GGGGGGGGCGGGGCGGCGGGC00GG1
1GCGC00C0CGGG0GG0000CGGGGGGCGGGGGGG000G1
1G0GGGGGGGGGG0G00GGG0GGGGGG00000C000G0G1
1GC00000C00000G0GGG0CGGGGGGGGCGGGCGGGCG1
1GGGGGGGGGGGG000CCGEGGGGGGGGGGGGGGGGGGG1
1111111111111111111111111111111111111111