11111111111111111111111111
10000000000000000000C00001
1C000P0000000C000000000001
10000000000000000000000001
10000111111100010000010001
100001CCCCCCCCC10000010001
100001CCCCCCECC11111110001
1C0001CCCCCCCC010000010001
10000111111100010000010001
1000000000000C000000000001
10C00000000000000000000001
10000000000000000C00000001
11111111111111111111111111
