11111111
10EPC001
1CCCCCC1
11111111
