11111111111111111111111111111
1P0C0C0C0C0C0C0C0C0C0C0C0C0C1
11111111111111111111111111101
1C0C0C0C0C0C0C0C0C0C0C0C0C1C1
10111111111111111111111110101
1C1C0C0C0C0C0C0C0C0C0C0C1C1C1
10101111111111111111111010101
1C1C1C0C0C0C0C0C0C0C0E1C1C1C1
10101011111111111111111010101
1C1C1C0C0C0C0C0C0C0C0C0C1C1C1
10101111111111111111111110101
1C1C0C0C0C0C0C0C0C0C0C0C0C1C1
10111111111111111111111111101
1C0C0C0C0C0C0C0C0C0C0C0C0C0C1
11111111111111111111111111111